{
	"name": "Test Map 20x20",
	"description": "Small 20x20 map for regression and bot testing",
	"gameId": "test001",
	"mapData": {
		"width": 20,
		"height": 20,
		"settings": {
			"enableTraps": false
		},
		"terrain": [
			[0,0,0,0,0,0,0,0,0,0,0,0,0,0,0,0,0,0,0,0],
			[0,0,0,0,0,0,0,0,0,0,0,0,0,0,0,0,0,0,0,0],
			[0,0,0,0,0,0,0,0,0,0,0,0,0,0,0,0,0,0,0,0],
			[0,0,0,0,0,0,0,0,0,0,0,0,0,0,0,0,0,0,0,0],
			[0,0,0,0,0,0,0,0,0,0,0,0,0,0,0,0,0,0,0,0],
			[0,0,0,0,0,0,0,0,0,0,0,0,0,0,0,0,0,0,0,0],
			[0,0,0,0,0,0,0,0,0,0,0,0,0,0,0,0,0,0,0,0],
			[0,0,0,0,0,0,0,0,0,0,0,0,0,0,0,0,0,0,0,0],
			[0,0,0,0,0,0,0,0,0,0,0,0,0,0,0,0,0,0,0,0],
			[0,0,0,0,0,0,0,0,0,0,0,0,0,0,0,0,0,0,0,0],
			[0,0,0,0,0,0,0,0,0,0,0,0,0,0,0,0,0,0,0,0],
			[0,0,0,0,0,0,0,0,0,0,0,0,0,0,0,0,0,0,0,0],
			[0,0,0,0,0,0,0,0,0,0,0,0,0,0,0,0,0,0,0,0],
			[0,0,0,0,0,0,0,0,0,0,0,0,0,0,0,0,0,0,0,0],
			[0,0,0,0,0,0,0,0,0,0,0,0,0,0,0,0,0,0,0,0],
			[0,0,0,0,0,0,0,0,0,0,0,0,0,0,0,0,0,0,0,0],
			[0,0,0,0,0,0,0,0,0,0,0,0,0,0,0,0,0,0,0,0],
			[0,0,0,0,0,0,0,0,0,0,0,0,0,0,0,0,0,0,0,0],
			[0,0,0,0,0,0,0,0,0,0,0,0,0,0,0,0,0,0,0,0],
			[0,0,0,0,0,0,0,0,0,0,0,0,0,0,0,0,0,0,0,0]
		],
		"waves": [
			[1,1,1,1,1,1,1,1,1,1,1,1,1,1,1,1,1,1,1,1],
			[1,1,1,1,1,1,1,1,1,1,1,1,1,1,1,1,1,1,1,1],
			[1,1,1,1,1,1,1,1,1,1,1,1,1,1,1,1,1,1,1,1],
			[1,1,1,1,1,1,1,1,1,1,1,1,1,1,1,1,1,1,1,1],
			[1,1,1,1,1,1,1,1,1,1,1,1,1,1,1,1,1,1,1,1],
			[1,1,1,1,1,1,1,1,1,1,1,1,1,1,1,1,1,1,1,1],
			[1,1,1,1,1,1,1,1,1,1,1,1,1,1,1,1,1,1,1,1],
			[1,1,1,1,1,1,1,1,1,1,1,1,1,1,1,1,1,1,1,1],
			[1,1,1,1,1,1,1,1,1,1,1,1,1,1,1,1,1,1,1,1],
			[1,1,1,1,1,1,1,1,1,1,1,1,1,1,1,1,1,1,1,1],
			[1,1,1,1,1,1,1,1,1,1,1,1,1,1,1,1,1,1,1,1],
			[1,1,1,1,1,1,1,1,1,1,1,1,1,1,1,1,1,1,1,1],
			[1,1,1,1,1,1,1,1,1,1,1,1,1,1,1,1,1,1,1,1],
			[1,1,1,1,1,1,1,1,1,1,1,1,1,1,1,1,1,1,1,1],
			[1,1,1,1,1,1,1,1,1,1,1,1,1,1,1,1,1,1,1,1],
			[1,1,1,1,1,1,1,1,1,1,1,1,1,1,1,1,1,1,1,1],
			[1,1,1,1,1,1,1,1,1,1,1,1,1,1,1,1,1,1,1,1],
			[1,1,1,1,1,1,1,1,1,1,1,1,1,1,1,1,1,1,1,1],
			[1,1,1,1,1,1,1,1,1,1,1,1,1,1,1,1,1,1,1,1],
			[1,1,1,1,1,1,1,1,1,1,1,1,1,1,1,1,1,1,1,1]
		],
		"treasures": [
			[0,0,0,0,0,0,0,0,0,0,0,0,0,0,0,0,0,0,0,0],
			[0,0,0,0,0,0,0,0,0,0,0,0,0,0,0,0,0,0,0,0],
			[0,0,0,0,0,0,0,0,0,0,0,0,0,0,0,0,0,0,0,0],
			[0,0,0,0,0,0,0,0,0,0,0,0,0,0,0,0,0,0,0,0],
			[0,0,0,0,0,0,0,0,0,0,0,0,0,0,0,0,0,0,0,0],
			[0,0,0,0,0,20,0,0,0,0,0,0,0,0,20,0,0,0,0,0],
			[0,0,0,0,0,0,0,0,0,0,0,0,0,0,0,0,0,0,0,0],
			[0,0,0,0,0,0,0,0,0,0,0,0,0,0,0,0,0,0,0,0],
			[0,0,0,0,0,0,0,0,0,30,50,0,0,0,0,0,0,0,0,0],
			[0,0,0,0,0,0,0,0,30,50,100,30,0,0,0,0,0,0,0,0],
			[0,0,0,0,0,0,0,0,50,100,100,50,0,0,0,0,0,0,0,0],
			[0,0,0,0,0,0,0,0,0,30,50,0,0,0,0,0,0,0,0,0],
			[0,0,0,0,0,0,0,0,0,0,0,0,0,0,0,0,0,0,0,0],
			[0,0,0,0,0,0,0,0,0,0,0,0,0,0,0,0,0,0,0,0],
			[0,0,0,0,0,20,0,0,0,0,0,0,0,0,20,0,0,0,0,0],
			[0,0,0,0,0,0,0,0,0,0,0,0,0,0,0,0,0,0,0,0],
			[0,0,0,0,0,0,0,0,0,0,0,0,0,0,0,0,0,0,0,0],
			[0,0,0,0,0,0,0,0,0,0,0,0,0,0,0,0,0,0,0,0],
			[0,0,0,0,0,0,0,0,0,0,0,0,0,0,0,0,0,0,0,0],
			[0,0,0,0,0,0,0,0,0,0,0,0,0,0,0,0,0,0,0,0]
		],
		"traps": [
			[0,0,0,0,0,0,0,0,0,0,0,0,0,0,0,0,0,0,0,0],
			[0,0,0,0,0,0,0,0,0,0,0,0,0,0,0,0,0,0,0,0],
			[0,0,0,0,0,0,0,0,0,0,0,0,0,0,0,0,0,0,0,0],
			[0,0,0,0,0,0,0,0,0,0,0,0,0,0,0,0,0,0,0,0],
			[0,0,0,0,0,0,0,0,0,0,0,0,0,0,0,0,0,0,0,0],
			[0,0,0,0,0,0,0,0,0,0,0,0,0,0,0,0,0,0,0,0],
			[0,0,0,0,0,0,0,0,0,0,0,0,0,0,0,0,0,0,0,0],
			[0,0,0,0,0,0,0,0,0,0,0,0,0,0,0,0,0,0,0,0],
			[0,0,0,0,0,0,0,0,0,0,0,0,0,0,0,0,0,0,0,0],
			[0,0,0,0,0,0,0,0,0,0,0,0,0,0,0,0,0,0,0,0],
			[0,0,0,0,0,0,0,0,0,0,0,0,0,0,0,0,0,0,0,0],
			[0,0,0,0,0,0,0,0,0,0,0,0,0,0,0,0,0,0,0,0],
			[0,0,0,0,0,0,0,0,0,0,0,0,0,0,0,0,0,0,0,0],
			[0,0,0,0,0,0,0,0,0,0,0,0,0,0,0,0,0,0,0,0],
			[0,0,0,0,0,0,0,0,0,0,0,0,0,0,0,0,0,0,0,0],
			[0,0,0,0,0,0,0,0,0,0,0,0,0,0,0,0,0,0,0,0],
			[0,0,0,0,0,0,0,0,0,0,0,0,0,0,0,0,0,0,0,0],
			[0,0,0,0,0,0,0,0,0,0,0,0,0,0,0,0,0,0,0,0],
			[0,0,0,0,0,0,0,0,0,0,0,0,0,0,0,0,0,0,0,0],
			[0,0,0,0,0,0,0,0,0,0,0,0,0,0,0,0,0,0,0,0]
		],
		"bases": [
			[0, 0],
			[19, 0],
			[0, 19],
			[19, 19]
		]
	},
	"players": [
		{ "playerId": "team_13", "name": "Team 13" },
		{ "playerId": "team_14", "name": "Team 14" },
        { "playerId": "team_15", "name": "Team 15" },
        { "playerId": "team_16", "name": "Team 16" }
	]
}
