{
	"name": "TEST004",
	"description": "Map 21x21, có sóng, không đảo, có bẫy",
	"gameId": "test004",
	"mapData": {
		"width": 21,
		"height": 21,
		"settings": {
			"enableTraps": true,
            "maxEnergy": 100,
            "energyRestore": 5,
            "maxTurns": 1200,
            "timeLimitMs": 300000,
            "tickIntervalMs": 500
		},
		"terrain": [
			[0, 0, 0, 0, 0, 0, 0, 0, 0, 0, 0, 0, 0, 0, 0, 0, 0, 0, 0, 0, 0],
			[0, 0, 0, 0, 0, 0, 0, 0, 0, 0, 0, 0, 0, 0, 0, 0, 0, 0, 0, 0, 0],
			[0, 0, 0, 0, 0, 0, 0, 0, 0, 0, 0, 0, 0, 0, 0, 0, 0, 0, 0, 0, 0],
			[0, 0, 0, 0, 0, 0, 0, 0, 0, 0, 0, 0, 0, 0, 0, 0, 0, 0, 0, 0, 0],
			[0, 0, 0, 0, 0, 0, 0, 0, 0, 0, 0, 0, 0, 0, 0, 0, 0, 0, 0, 0, 0],
			[0, 0, 0, 0, 0, 0, 0, 0, 0, 0, 0, 0, 0, 0, 0, 0, 0, 0, 0, 0, 0],
			[0, 0, 0, 0, 0, 0, 0, 0, 0, 0, 0, 0, 0, 0, 0, 0, 0, 0, 0, 0, 0],
			[0, 0, 0, 0, 0, 0, 0, 0, 0, 0, 0, 0, 0, 0, 0, 0, 0, 0, 0, 0, 0],
			[0, 0, 0, 0, 0, 0, 0, 0, 0, 0, 0, 0, 0, 0, 0, 0, 0, 0, 0, 0, 0],
			[0, 0, 0, 0, 0, 0, 0, 0, 0, 0, 0, 0, 0, 0, 0, 0, 0, 0, 0, 0, 0],
			[0, 0, 0, 0, 0, 0, 0, 0, 0, 0, 0, 0, 0, 0, 0, 0, 0, 0, 0, 0, 0],
			[0, 0, 0, 0, 0, 0, 0, 0, 0, 0, 0, 0, 0, 0, 0, 0, 0, 0, 0, 0, 0],
			[0, 0, 0, 0, 0, 0, 0, 0, 0, 0, 0, 0, 0, 0, 0, 0, 0, 0, 0, 0, 0],
			[0, 0, 0, 0, 0, 0, 0, 0, 0, 0, 0, 0, 0, 0, 0, 0, 0, 0, 0, 0, 0],
			[0, 0, 0, 0, 0, 0, 0, 0, 0, 0, 0, 0, 0, 0, 0, 0, 0, 0, 0, 0, 0],
			[0, 0, 0, 0, 0, 0, 0, 0, 0, 0, 0, 0, 0, 0, 0, 0, 0, 0, 0, 0, 0],
			[0, 0, 0, 0, 0, 0, 0, 0, 0, 0, 0, 0, 0, 0, 0, 0, 0, 0, 0, 0, 0],
			[0, 0, 0, 0, 0, 0, 0, 0, 0, 0, 0, 0, 0, 0, 0, 0, 0, 0, 0, 0, 0],
			[0, 0, 0, 0, 0, 0, 0, 0, 0, 0, 0, 0, 0, 0, 0, 0, 0, 0, 0, 0, 0],
			[0, 0, 0, 0, 0, 0, 0, 0, 0, 0, 0, 0, 0, 0, 0, 0, 0, 0, 0, 0, 0],
			[0, 0, 0, 0, 0, 0, 0, 0, 0, 0, 0, 0, 0, 0, 0, 0, 0, 0, 0, 0, 0]
			],
			"waves": [
			[1, 1, 1, 1, 1, 1, 1, 1, 1, 1, 1, 1, 1, 1, 1, 1, 1, 1, 1, 1, 1],
			[1, 1, 1, 1, 1, 1, 1, 1, 1, 1, 1, 1, 1, 1, 1, 1, 1, 1, 1, 1, 1],
			[1, 1, 1, 1, 1, 1, 1, 1, 1, 1, 1, 1, 1, 1, 1, 1, 1, 1, 1, 1, 1],
			[1, 1, 1, 1, 1, 1, 1, 1, 1, 1, 1, 1, 1, 1, 1, 1, 1, 1, 1, 1, 1],
			[1, 1, 1, 1, 4, 4, 4, 4, 4, 4, 2, 4, 4, 4, 4, 4, 4, 1, 1, 1, 1],
			[1, 1, 1, 1, 4, 5, 5, 5, 5, 5, 2, 5, 5, 5, 5, 5, 4, 1, 1, 1, 1],
			[1, 1, 1, 1, 4, 5, 5, 5, 5, 5, 3, 5, 5, 5, 5, 5, 4, 1, 1, 1, 1],
			[1, 1, 1, 1, 4, 5, 5, 1, 1, 1, 1, 1, 1, 1, 5, 5, 4, 1, 1, 1, 1],
			[1, 1, 1, 1, 4, 5, 5, 1, 1, 1, 1, 1, 1, 1, 5, 5, 4, 1, 1, 1, 1],
			[1, 1, 1, 1, 4, 5, 5, 1, 1, 1, 1, 1, 1, 1, 5, 5, 4, 1, 1, 1, 1],
			[1, 1, 1, 1, 2, 2, 3, 1, 1, 1, 1, 1, 1, 1, 3, 2, 2, 1, 1, 1, 1],
			[1, 1, 1, 1, 4, 5, 5, 1, 1, 1, 1, 1, 1, 1, 5, 5, 4, 1, 1, 1, 1],
			[1, 1, 1, 1, 4, 5, 5, 1, 1, 1, 1, 1, 1, 1, 5, 5, 4, 1, 1, 1, 1],
			[1, 1, 1, 1, 4, 5, 5, 1, 1, 1, 1, 1, 1, 1, 5, 5, 4, 1, 1, 1, 1],
			[1, 1, 1, 1, 4, 5, 5, 5, 5, 5, 3, 5, 5, 5, 5, 5, 4, 1, 1, 1, 1],
			[1, 1, 1, 1, 4, 5, 5, 5, 5, 5, 2, 5, 5, 5, 5, 5, 4, 1, 1, 1, 1],
			[1, 1, 1, 1, 4, 4, 4, 4, 4, 4, 2, 4, 4, 4, 4, 4, 4, 1, 1, 1, 1],
			[1, 1, 1, 1, 1, 1, 1, 1, 1, 1, 1, 1, 1, 1, 1, 1, 1, 1, 1, 1, 1],
			[1, 1, 1, 1, 1, 1, 1, 1, 1, 1, 1, 1, 1, 1, 1, 1, 1, 1, 1, 1, 1],
			[1, 1, 1, 1, 1, 1, 1, 1, 1, 1, 1, 1, 1, 1, 1, 1, 1, 1, 1, 1, 1],
			[1, 1, 1, 1, 1, 1, 1, 1, 1, 1, 1, 1, 1, 1, 1, 1, 1, 1, 1, 1, 1]
			],
			"treasures": [
			[0, 0, 0, 0, 0, 0, 0, 0, 0, 0, 0, 0, 0, 0, 0, 0, 0, 0, 0, 0, 0],
			[0, 0, 0, 0, 0, 0, 0, 0, 0, 0, 0, 0, 0, 0, 0, 0, 0, 0, 0, 0, 0],
			[0, 0, 0, 0, 0, 0, 0, 0, 10, 10, 10, 10, 10, 0, 0, 0, 0, 0, 0, 0, 0],
			[0, 0, 0, 0, 0, 0, 0, 0, 0, 0, 0, 0, 0, 0, 0, 0, 0, 0, 0, 0, 0],
			[0, 0, 0, 0, 0, 0, 0, 0, 0, 0, 0, 0, 0, 0, 0, 0, 0, 0, 0, 0, 0],
			[0, 0, 0, 0, 0, 0, 0, 0, 0, 0, 0, 0, 0, 0, 0, 0, 0, 0, 0, 0, 0],
			[0, 0, 0, 0, 0, 0, 0, 0, 0, 0, 0, 0, 0, 0, 0, 0, 0, 0, 0, 0, 0],
			[0, 0, 0, 0, 0, 0, 0, 0, 0, 0, 0, 0, 0, 0, 0, 0, 0, 0, 0, 0, 0],
			[0, 0, 10, 0, 0, 0, 0, 0, 50, 50, 50, 50, 50, 0, 0, 0, 0, 0, 10, 0, 0],
			[0, 0, 10, 0, 0, 0, 0, 0, 50, 100, 100, 100, 50, 0, 0, 0, 0, 0, 10, 0, 0],
			[0, 0, 10, 0, 0, 0, 0, 0, 50, 100, 100, 100, 50, 0, 0, 0, 0, 0, 10, 0, 0],
			[0, 0, 10, 0, 0, 0, 0, 0, 50, 100, 100, 100, 50, 0, 0, 0, 0, 0, 10, 0, 0],
			[0, 0, 10, 0, 0, 0, 0, 0, 50, 50, 50, 50, 50, 0, 0, 0, 0, 0, 10, 0, 0],
			[0, 0, 0, 0, 0, 0, 0, 0, 0, 0, 0, 0, 0, 0, 0, 0, 0, 0, 0, 0, 0],
			[0, 0, 0, 0, 0, 0, 0, 0, 0, 0, 0, 0, 0, 0, 0, 0, 0, 0, 0, 0, 0],
			[0, 0, 0, 0, 0, 0, 0, 0, 0, 0, 0, 0, 0, 0, 0, 0, 0, 0, 0, 0, 0],
			[0, 0, 0, 0, 0, 0, 0, 0, 0, 0, 0, 0, 0, 0, 0, 0, 0, 0, 0, 0, 0],
			[0, 0, 0, 0, 0, 0, 0, 0, 0, 0, 0, 0, 0, 0, 0, 0, 0, 0, 0, 0, 0],
			[0, 0, 0, 0, 0, 0, 0, 0, 10, 10, 10, 10, 10, 0, 0, 0, 0, 0, 0, 0, 0],
			[0, 0, 0, 0, 0, 0, 0, 0, 0, 0, 0, 0, 0, 0, 0, 0, 0, 0, 0, 0, 0],
			[0, 0, 0, 0, 0, 0, 0, 0, 0, 0, 0, 0, 0, 0, 0, 0, 0, 0, 0, 0, 0]
			],
		"bases": [[1,1],[19,1],[1,19],[19,19]]
	},
	"players": [
		{ "playerId": "team_13", "name": "Team 13" },
		{ "playerId": "team_14", "name": "Team 14" },
        { "playerId": "team_15", "name": "Team 15" },
        { "playerId": "team_16", "name": "Team 16" }
	]
}
